11111111111111111
1P00000N000000C01
10000000000000001
100C0000000C00001
10000111110000001
100011E0000C00001
11111111111111111
