11111111111111111
10P000000000000C1
10000000C00000001
100C0000000000001
10000111110000001
100011E0000000001
10001100000000001
11111111111111111
