11111111111111111
1P00000N000000C01
10PP000000NNN0001
100C000000NC00001
1000011011NN00001
100C0100110000001
10001E01110C00N01
11111111111111111
